       WWWWWWWWWWWWWWWWWWWWWWWWW
      W-------------------------WWW
     W-----p-----------------------W
    W-----------------------------s-W
    W------------------------s------W
     W-----------------------WWWWWWWWW
        W---s----WWWW-----------------W    
       W------WWW------------s---------W
      WWWWWWWWWWWW--------------------W
     W- ---------W--------WWWWWWWWWWWWWWW
    W------------W--s-------------------W     
   W-------s-----W-----------------------W
    W-------------WWW-WWWW-WWWWW---s---s--W
   W---s-------s---W--W----------W---------W
  W---------------W--W--------------WWWWW---W
 W--WWWWWWWWWWWWWW--W-------------------W---W
  W----------s--W--W--------------------W-s-W
   W--s--------W---W------------------WWWW---W  
  W-----------------------------s----W------W
   W----------s---------------------W----s-W
    W----s---------------------------W-----W
     W--------------------------------W----W
     W------------------------------s-W---W
      W-----------------------------------W
    W------------------------------------W
     W----------------------------------W
      W---------------------------------W
       W--------------------------------W
        W-------------------------------W
        W------------------------------W
        W--------------------------- -W
        W----------------------------W
        W---------------------------W
         W--------------------------W
          WWWWWWWWWWWWWWWWWWWWWWWWWW
