fffffffffffffffffffffffffffffffffffffffffffffffff
ffWWWWWWWWWWWWWWWWWWWWWWWWWWWWWWWWWWWWWWWWWWWWWff
fW-------W----------W--------------------------Wf
fW-------W----------W--------------------------Wf
fW--W--WWW--WWWWWW--W--WWWWWWWWWWWWW--WWWWWW---Wf
fW--W--- ---W-------------------W----------W---Wf
fW--W-------W-------------------W----------W---Wf
fW--W-------W--WWWWWWWWWWWWWWW--W--W--WWW--WWWWWf
fW--W-------W--W-------------W--W--W----W------Wf
fW--W-------W--W-------------W--W--W----W------Wf
fW--WWWWWWWWW--WWWW--WWW--W--W--WWWWWW--WWWWW--Wf
fW----------------W----W--W---------------W----Wf
fW----------------W----W--W---------------W----Wf
fW--WWWWWWWWWWWWWWW--WWW--WWWWWW--WWW--WWWW--WWWf
fW--W-------------W----W------------W--W-------Wf
fW--W-------------W----W------------W----------Wf
fW--W--WWWWWWWWW--WWW--WWWWWWWWWWWWWW-----WWW--ff
ff--W--W----------W-----------------WWWWWWW----Wf
fW--W--W----------W-----------------W-----W----Wf
fWWWW--WWWWWWW--WWWWWWWWWWWWWWWWWW--W-----WWW--Wf
fW-----------W--------W----------W-----W--W----Wf
ff-----------W--------W----------W-----W--W----Wf
fW--WWWW--W--WWW--WWWWWWW--WWWW--WWWWWWW--W--WWWf
fW--W-----W----W--W--W------W----W--------W----Wf
fW--W-----W----W--W--W------W----W--------W----Wf
fW--WWWW--WWWWWW--W--WWWWW--W--WWW--WWWWWWWWW--Wf
fW-----W----------W----W----W-------W--W-------Wf
fW-----W----------W----W----W-------W--W-------Wf
fWWWW--WWWWWWW--WWWWW--W--WWWWWWWWWWW--W--WWW--Wf
fW--------------W------W----W----------W----W--Wf
fW--------------W------W----W----------W----W--Wf
fW--W--WWWWWWW--W--WW--WWW--WW--WWW--WWW--WWW--Wf
fW--W--------W-----W------------W---------W----Wf
fWp-W--------W-----W------------W---------W----Wf
fWWWWWWWWWWWWWWWWWWWWWWWWWWWWWWWWWWWWWWWWWWWWWWWf
fffffffffffffffffffffffffffffffffffffffffffffffff