        WWWWWWWWWWWWWWWWWWWWWWWW
       W----------W----s--------WWW
       W- --------W----------------W
       W----------W---------------s-W
      W-----------W----------s------W
     W-----------------------WWWWWWWW
     W---s-------WWW-----------------W    
     W------WWW------------s---------W
     WWWWWfWWWWWW---------------------W
     W- ---------W--------WWWWWWWWWWWWWW
     W-----------W--s-------------------W     
      W----s-----W-----------------------W
      W-----------WWW-WWWWWW--WW---s---s--W
      W---s----s---W--W---------WWWW-------W
      W-----------W--W--------------WWWWW---W
     W--WWWWWWWWWW--W----WWWWWW---------W---W
     W-------s--W--W----W------W-----s--W-s-W
     W--s------W---W---W--WWW---W-----WWW---W  
    W--------s--W---WWW---W--W--W----W------W
    Ws-----------WW-----WW----W-W---W----s-W
    W------W--W----WWWWW---WWW--W----W-----W
     W-s----W--W----------W--s-WW-----W----W
     W------W--W------WWWW--WWWW-W--s-W---W
     W-----W--W------W-----W---W-W----W--W
     W------W--W----W--WWWW---W--W---W---W
      W------W--W--W--W-------W--W---W--W
      W---s---W-W-W--W----p---W--W---W--W
       W------W--WW--W------WWW--W---W--W
        W------W---s-W-----W----W----W--W
        W-------WWWWW-----W--WWW----W--W
        W-----------W----W--W---s--W--W
        W----s------f----f--W----WW--W
        W-----------W-----W--WfWW---W
         W----------W-----W--------sW
          WWWWWWWWWWWWWWWWWWWWWWWWWW
