   WWWWWWWWWWWWWWWWWWWWWWW
 fW---W------s------------Wf
 W-------W------W------W---W
fW---s-W---W--------W------Wf
fW--------------s-------s--Wf
fW---W---------W------W----Wf
fW-------W--------W--------Wf
fW-W--s-----------W------WsWf
fWWWWWWWWWWWWWWWWWW--WWWWWWWf
fW------------W------------Wf
fW--s---------W------s-----Wf
fW------------W------------Wf
fW------------W---------s--Wf
 W-------s-----------------W
fW--s---------W----WWWWWWWWWf
fW------------W----W----s--Wf
fW--------W---W------------Wf
fWWWWWWW--WWWWWWWWWWWWWWWWWWf
fW-s-----------------------Wf
fW-------------------------Wf
fWWWWWWWWWWWWWWWWWWWWWWW---Wf
fW-------------------------Wf
fW----s--------------------Wf
fW-------------------------Wf
 W-------------------------W
 fW-----------p-----------Wf
   WWWWWWWWWWWWWWWWWWWWWWW