         WWWWWWWWW
      WWW----s----WWW
   WWW-------W-------WWW
   W-s---------------s-W
   W-------------------W
  W----W-----P-----W----W
  W---------------------W
  W---------------------W
 W-----------------------W
 W-s-W-------B-------W-s-W
 W-----------------------W
  W---------------------W
  W---------------------W
  W----W-----p-----W----W
   W-------------------W
   W-s---------------s-W
   WWW-------W-------WWW
      WWW----s----WWW
         WWWWWWWWW