--WWWWWWWWW
------W---W
W-----W---WWWWWWWWWWWWWWWWWWWWWWWWWWWWWWW
W-----W---W
W-----W---W
W-----W---W
WW---WWWW-W
 W---Wp---W
 W---WW---W
 W-s-----sW
 W--s---s-W
 W----s---W
 ffffffff-f
 f--------f
 f--------f
 ffffffffff