WWWWWWWWWWW
W-----W---W
W-----W---WWWWWWWWWWWWWWWWWWWWWWWWWWWWWWW
W-----W---W
W-----W---W
W-----W---W
WW---WWWW-W
 W---Wp---W
 W---WW---W
 W--------W
 W---s----W
 W--------W
 wwwwwwww-w
 w--------w
 w--------w
 wwwwwwwwww