WWWWWWW
W-----W
W--P--W
W--p--W
W-----W
W-----W
WWWWWWW