      WWWWWWWWWWWWW
     W-------------W
   WW----s--s--s----WW
  W--------WWW--------W
 W-------s-W-W-s-------W
 W---------fff---------W
 W----------P----------W
  W-------------------W
   W-----------------W 
    W---------------W
     W-------------W
     W--WWWWWWWWW--W
     W--WWWWWWWWW--W
     W------p------W
      W-----------W
       WWWWWWWWWWW